A|a
Ă|á
Â|ớ
B|bê
C|xê
D|đê
Đ|đê
E|e 
Ê|ê
F|ép
G|gờ
H|hát
I|i 
J|gi
K|ca
L|lờ
M|mờ
N|nờ
O|o
Ô|ô 
Ơ|ơ
P|pê
Q|quy
S|ét
R|rờ
T|tê
U|u
Ư|ư
V|vê
W|vê kép
X|ích xờ
Y|i
Z|dét
